.B......#..A..........###.B.......#...AB....A.....BAB.#..AA#.B......#.......#...AAA.#...B........B.B
....A..B#BA...A....A.............#..A..........BA...#B.A.#..A..#..........A.......#.....A..#BA......
..B#A.A..A.................#.......#.......A..#......#B...A.#.#...........A.A.....A....AA...B.......
......#..A....A....................A...A#.................#.........A.#....A....BAA#..#A.A..B...A...
....#A..A#B.........A......................A...........................A.A.............B.##.....#.A.
....AB.......A......A..#...A.......A......#..BAA.A#.#..A...A.........B......BB......B.#A.A..A.......
...B..........A....B.......A...#....B.#.....A...A...A..........#..#.....B..B...A..A....A...A..A#....
..AAA....A.......A.....A.B.........A.....A....AAA.......A.............#........A.A..AAA.............
A....A........#..#.#...#............A...A........A.......B.......B.........#AA.....BA.......A.......
.........A.............A.......#....BA.....B.A....A........................B...A#....A#.........B.#A
..A....#.....A.#......#.#.........A..#......#.......A........A.A##...A...#.A.A..#.#.................
.AA........#..................A...BB..#.#...B..............A.....A................A.....#.....B.....
..A.#A...........A..........#.A........B.......A..........A........A..........A.A........B..A.......
....B.....A.B...A...........A..A.....#......AA#.AA....#........A....B....B...B....B.......#B....A...
B.....#..BB.....BA....A..........A.A.A#.A..#..#.A...#...AA.A.........A.#..A.B..#...........ABAA.#...
....................A............A....A......A.A...A.A...............A.#..A.......A....A.......A....
.........A#...A#..B......AB........A....#...A.#A..A.A.#AA#..#A..........B..A....A......A...#.#.....A
.A...........A.........A.....#.......A........A...#.A.........A.#..A.........AA.A....#..AA..A......A
............A........A......A...#.#AA......A...#B....A.........B.#....A..A..A....A..................
..............A.......A...........B#....#A.............A............A...B#A.AA..A...A..#...A..A..A..
.A.........#.....#..A.AAA.......AA............#............#A.......A...#...A..A#.......A..#.#.....A
..A....B...A.B..#B.#.#....B.....##A.#....A....#......A..B..............B...#.......#..AA.......A....
..A..........BA.#....A...A...A...A.......AAA...A..A.......#AB..A..#.....#...B....#...A#.............
A..A..#.AA........#.A.......A..A.....A..AA...#.....#...........A..A.......#..........A.....A.....B..
#A..............A...A.........A.A...#.A..AA...A..B......A..#..A...#.............A......#.#.A..A.....
A..#.......##.....#.A......A......#......A......AA.#.....A..B............A.BA...B..#..A#....#.....A.
.........A.A.A#.....A...........#...A....B.....AAAA..A.A....A.......ABA..B.#.AA...#AAA..............
..#..A.#..........#............A....#....A.............A....A.A..#.....A...#A.......#..A............
..B......B..A...A.......A...........#A.....A...........AA............A......A.......A..#......A....A
.....A...........AA.A.......##.B....A....#........AA.....A.......BAAA......AA......A....A.....A.B#..
.................A....AA........A...#......A#....A..A....#.....#.A.A..........A.B#.....A.A.......B.A
.A...AA..A.B..A.......A....#.A.....A.......A...#....AA.......A.AA............B....#BA......AA.A...A.
.....A...A......#..........A........#........B...B.B.............A............A...#....A...#........
.A.......AA.A.A.......A.........#..A#A..........#A.A#.....B.....A.B........A........A..A...A.A...AB.
.A..AA.B.................A...#...A........B..A#..#.A.AAB.BB.A...A...B.......A....A.A.A......#...B.B.
..A........B......#......A..#..#A.A..A................B#A..#A..........A#A...B.#......#..A#...A.....
AA.AAA..............A..#..AB...B....A....A..A.....#...AA......BAA.B........A.....AB.B...#....A.#....
...............B.....A...A...A.A.........A..A.........A...A........A.A...........#..B.....A...A.A#.#
.....#.......BA........A................A#.A.......A..#..........#..#.#.#...AAB.....A..B#....A....#.
..AA.A..........A.A......B..#....B....AA...BAA#......#B......A.....A..A.A...#.......#....A.##A......
.............A.......#..A...#..AB.A....A...#..A.........AA..B...B......A.............B........A.B.B#
.A....B.......BA.A.#.......#.....A.A..........#.....#..............A.B.#...A.A.......A...A...##.....
......A..........B......BA...A.#..B.A....A............A......A#.B.......A#.....B.A.....A.....AA.....
.A....A.......A..A.A.A..........A#.........#...A.A.....A.A..A..A.AA.#......A.........A....A.A.....A.
......A.AA........#..#.A....AA.A.A...A..A.....A....B.........B#B..........#............A.#.A...A....
......AA...A.A.................#B....A...#.A..A...........A.....B..........AA............B....A.B...
....#A##..A.#....A.B..A.......B....#....A...B.........A......AA.#........A.........A.......A..B.....
A.......................B#..........A.B..#..A......B..A.....#.A.A......A...B....A...A.AA............
......A............A.B.A....A......A##.................BA...AA....A...............A..A....A.#.......
.......#...B.......A....#..##....A..................BA.....B..A.....AA.A.....A#.A.....A.A..A.....A.A
.....B....A...A............#...A.##.A...A......A.A....A...............A.......B...B..#A.......AA..A.
.....A......A....#..A.....A.#....................B.....#.AA......AA........A.A..A..A.........BA.....
.......#..#..AA..B.A..B....A...B...A.....A.....AA...........#.A.....AAA..AA...........A.............
..##...........A..........#...................A..........#..#.A.............A...A.#A....#.B#..#..A#.
..A...A..#.....BAB.............BA.............B#........B.........#.................A.....#B.A......
..................AA....A.....A....A.A...#A.A....AB.........A.......A.......A....A..A...AA...A....AA
........B.......A....A......##...AAAAA..#...A..A..................#..........#....B.................
A#.#A.....AB..B........BAA.......A.B..A.A.A......B.BAAA.......B.B...A..A...#.......A.#....A.........
.A........AA.A...A........A.............B#...#....B..#.......A..........#A.........A....A.....AA....
.........A..#........A.#........A..#..A.......#.A.B.......#...A..#.#.....AA.A.A......A..A.A.AA......
B........#.A..A........A.....A.A.A..A.........#....#..A........A.......A.....#.......A..A.A.A....A..
............A.......A....AA.#...............#....#..B...........#A..#.B...#A.....#.....A........A...
....A..............B....AAA.......A#...........A.......A.B...B.....#....A.##.A.....AAA.B.......A....
.A......A..AA................A......A........AA....AAA........B..A....A..............#.A.#A..A.#....
.#....B..A##A.#......B...A....A....A..A..A..AA#..A..........#...#......A...#A.......A....#.........A
A..A...A....A.A...#.........#........A#A...........A...A........AAA................A.........#.A#...
.....#....##A.............A#.A...#........BA......A.........A............A.........B................
.A.#A.........B..A..A..A..............A...A.A....AA#.#BAA..#..............#.BB........A..........AB.
.....A.......AAA....#.#....B#.........A..B.....A......A.....A...B.......#A.A..A...#..A...A..A.......
A................A#.A.........A................BA..#..A..A.A.#.....A.A..A.BB...ABA.......A..........
...................A...........AA#.......A......A....................A..#....##............A..A..A#.
.....A.....B.B.A..........#...........A..........A...#...............A..........A...#......A........
..........................B..A.......A...A..#.A..A........A........#.....A...B.B.............#....#.
#A....AA..A...B..................BAAA....B....#..A.....BA..B..A.A......#.##....#....#......A.A....#.
....#...#....#.B..A..................A......B......A....A............A.B.#...A..A..A.....#...A.#..AA
........................#.....#.......#.....#.A.....B..............A.......A................#.A#...#
..#A......A....A.A.........A.#..A.......A..A.........A................A...........A........A...ABA.A
...#.A...A.AA......A.A..................A..A......A...A....A..................#A.A..A.#A..........##
..........................#..B....A.#.#.........AA.....#..A...B.....#..A..B..#.............A.A..#...
....A......A.#.A..A.#.......A...AA....A.......A...A..#.........A...A.........#A..A.............AB..A
.....A...A#A...A.#...................A..A...A...................................A...........A.......
.A.....B....#....A......A.....A...#.....A..............#.A#...........#..A..A....#.......AB.....A.B.
.........A.B......A.A..#BA.A..A...AA.A.....#..A.A...........A............#.....#..........A.#.AA...B
.....AAA..........A.........A........B..A..........#..A..A...A..A....BA.AAA.....A.##...#B...A.......
........A....A..A...............BA................A....AA#A...AA.A...#........A...A..A...A#...BA..B.
..A..#..#.....#A.........#............#.#A......A....#...A....#.A......A....AA#A.........#..BAB.....
.A........A.#........A.........A...A........A....A..................##.A.......#.AAAA.......BA..AAB.
.AA#.A........AA..A.#A........A........A.B....B.....A.A##.#A.A....B......#.A.B..A.....A......#.A.A.A
...................A.......A...A.......A....A.AAA#B...........AA...........A..AA..A.A........A......
.A.B..A..A............A.....B....A...A.................#A..........#....A.#.#..A....B...............
.A.#.#...B......#.....AA......A.......A...A.#A....A...A.......BA......A......A.AAA....A.A..B........
..........A#..A.##..A......A...A.......................A..........A.........#.A.....A........#A..#A#
B....#..A.A.A.....A.....A.A....#..B.B.........BAA.B.........A........#...........B.A....#....A..B..#
...A.........A...........A...........A....B#......AA#.......#...........A..B.A......B.A.A...A.AA.A..
....A.....AA.........AA.................B.......A...B..B.........A.A.....A.......A..B...#..A........
..B...B............#.A.#........##..A..............A....A...A........B......B.A#.B....A.......#A.#..
...#....A...A..#.A.A................A#....B........#..A..#...........A.A..A..A.A..B.......#A........
...........A.A.................A.#.#......A....#......A...A............A..A.A..A...#.A..A.ABA...B...
A.A........A#..##.A.........#.......B.......A..A.....A............A....A..#.....AB..B......A#.......
.A.B..#....#.......AA....A......A.A#.....A................AA....A..........A..A.......A..A..A...A...
